러브스토리인하버드	러브/ncn	스토리/ncn	인/ncn	하버드/ncn
표준점수제	표준/ncn	점수제/ncn
사장님죽이기	사장님/ncn	죽이/pv	기/etn
사장님죽이기는	사장님/ncn	죽이/pv	기/etn	는/j
사장님죽이기에서	사장님/ncn	죽이/pv	기/etn	에서/j
사장님죽이기를	사장님/ncn	죽이/pv	기/etn	를/j
안과밖	안/ncn	과/j	밖/ncn
안과밖에서	안/ncn	과/j	밖/ncn	에서/j
안과밖이고	안/ncn	과/j	밖/ncn	이고/j
안과밖에	안/ncn	과/j	밖/ncn	에/j
난의연가	난/ncn	의/j	연가/ncn
난의연가를	난/ncn	의/j	연가/ncn	를/j
난의연가는	난/ncn	의/j	연가/ncn	는/j
난의연가에	난/ncn	의/j	연가/ncn	에/j
난의연가에서	난/ncn	의/j	연가/ncn	에서/j
피나요	피/ncn	나/pv	요/ef
고치는	고치/pv	는/ef
고치고	고치/pv	고/ef
고치면	고치/pv	면/ef
고치다	고치/pv	다/ef
가지는	가지/pv	는/ef
배니	배/pv	니/ef
베는	베/pv	는/ef
베서	베/pv	서/ef
베면	베/pv	면/ef
붙이는	붙이/pv	는/ef
대는	대/pv	는/ef
나나요	나/pv	나요/ef
물의날이	물/ncn	의/j	날/ncn	이/j
물의날은	물/ncn	의/j	날/ncn	은/j
물의날을	물/ncn	의/j	날/ncn	을/j
물의날에	물/ncn	의/j	날/ncn	에/j
네멋대로해라	네/np	멋대로/ma	하/pa	어라/ef
네멋대로해라는	네/np	멋대로/ma	하/pa	어라/ef	는/j
네멋대로해라가	네/np	멋대로/ma	하/pa	어라/ef	가/j
네멋대로해라에서	네/np	멋대로/ma	하/pa	어라/ef	에서/j
네멋대로해라를	네/np	멋대로/ma	하/pa	어라/ef	를/j
냉정과열정사이	냉정/ncp	과/j	열정/ncn	사이/ncn
냉정과열정사이에서	냉정/ncp	과/j	열정/ncn	사이/ncn	에서/j
냉정과열정사이는	냉정/ncp	과/j	열정/ncn	사이/ncn	는/j
냉정과열정사이가	냉정/ncp	과/j	열정/ncn	사이/ncn	가/j
냉정과열정사이를	냉정/ncp	과/j	열정/ncn	사이/ncn	를/j
8명의여인들	8/num	명/nbu	의/j	여인/ncn	들/xsn
믿지마세요는	믿/pv	지/ef	말/pv	세요/ef	는/j
믿지마세요가	믿/pv	지/ef	말/pv	세요/ef	가/j
믿지마세요에서	믿/pv	지/ef	말/pv	세요/ef	에서/j
믿지마세요를	믿/pv	지/ef	말/pv	세요/ef	를/j
폭풍속으로	폭풍/ncn	속으로/ma
폭풍속으로가	폭풍/ncn	속으로/ma	가/j
폭풍속으로를	폭풍/ncn	속으로/ma	를/j
폭풍속으로에서	폭풍/ncn	속으로/ma	에서/j
사랑한다말해줘	사랑/ncp	하/xsp	ㄴ다/ef	말해줘/ncn
사랑한다말해줘가	사랑/ncp	하/xsp	ㄴ다/ef	말해줘/ncn	가/j
사랑한다말해줘를	사랑/ncp	하/xsp	ㄴ다/ef	말해줘/ncn	를/j
사랑한다말해줘에서	사랑/ncp	하/xsp	ㄴ다/ef	말해줘/ncn	에서/j
위험한정사	위험/ncp	하/xsp	ㄴ/ef	정사/ncn
위험한정사를	위험/ncp	하/xsp	ㄴ/ef	정사/ncn	를/j
위험한정사가	위험/ncp	하/xsp	ㄴ/ef	정사/ncn	가/j
위험한정사에서	위험/ncp	하/xsp	ㄴ/ef	정사/ncn	에서/j
신구상회화	신/ncn	구상/ncp	회화/ncn
신구상회화는	신/ncn	구상/ncp	회화/ncn
여성전용선거구제	여성/ncn	전용/ncp	선거구제/ncn
여성전용선거구제는	여성/ncn	전용/ncp	선거구제/ncn	는/j
여성전용선거구제가	여성/ncn	전용/ncp	선거구제/ncn	가/j
여성전용선거구제를	여성/ncn	전용/ncp	선거구제/ncn	를/j
여성전용선거구제에서	여성/ncn	전용/ncp	선거구제/ncn	에서/j
악어의눈물	악어/ncn	의/j	눈물/ncn
악어의눈물이	악어/ncn	의/j	눈물/ncn	이/j
악어의눈물은	악어/ncn	의/j	눈물/ncn	은/j
악어의눈물을	악어/ncn	의/j	눈물/ncn	을/j
불의검	불/ncn	의/j	검/ncn
불의검이	불/ncn	의/j	검/ncn	이/j
불의검을	불/ncn	의/j	검/ncn	을/j
불의검은	불/ncn	의/j	검/ncn	은/j
불의검에서	불/ncn	의/j	검/ncn	에서/j
하라했는데	하/pv	라/ef	하/pv	었/ep	는데/ef
할베리	할/nq_per	베리/nq_per
태극기휘날리며	태극기/ncn	휘날리/pv	며/ef
태극기휘날리며의	태극기/ncn	휘날리/pv	며/ef	의/j
태극기휘날리며는	태극기/ncn	휘날리/pv	며/ef	는/j
태극기휘날리며가	태극기/ncn	휘날리/pv	며/ef	가/j
태극기휘날리며를	태극기/ncn	휘날리/pv	며/ef	를/j
태극기휘날리며에서	태극기/ncn	휘날리/pv	며/ef	에서/j
태극기휘날리며보다	태극기/ncn	휘날리/pv	며/ef	보다/j
발로차는	발/ncn	로/j	차/pv	는/ef
발로차고	발/ncn	로/j	차/pv	고/ef
책보다	책/ncn	보다/j
2000년의사랑	2000/num	년/nbu	의/j	사랑/ncp
이천년의사랑	이천/num	년/nbu	의/j	사랑/ncp
WCG2002	WCG/ncn	2002/num
wcg2002	WCG/ncn	2002/num
WCG2002의	WCG/ncn	2002/num	의/j
wcg2002의	WCG/ncn	2002/num	의/j
wcg2003	WCG/ncn	2003/num
wcg2001	WCG/ncn	2001/num
wcg2004	WCG/ncn	2004/num
WCG2001	WCG/ncn	2001/num
WCG2003	WCG/ncn	2003/num
WCG2004	WCG/ncn	2004/num
사나요	사/pv	나요/ef
열이	열/ncn	이/j
신이다.	신/ncn	이/jp	다/ef	./sf
신이라는	신/ncn	이라는/jp
신이라고	신/ncn	이라고/jp
신이나	신/ncn	이나/j		
머지여?	뭐/np	지여/jp	?/sf
머지요?	뭐/np	지요/jp	?/sf
과가	과/ncn	가/j
정부보호자격증	정부/ncn	보호/ncp	자격증/ncn
문자판독기	문자/ncn	판독기/ncn
광학식문자판독기	광학식/ncn	문자/ncn	판독기/ncn
채권시가평가제	채권/ncn	시가/ncn	평가제/ncn
공부방법	공부/ncp	방법/ncn
왓 어걸	왓어걸/ncn
주세요	주/pv	세요/ef
주세요.	주/pv	세요/ef	./sf
섬유의 날을	섬유/ncn	의/j	날/ncn	을/j
섬유의 날은	섬유/ncn	의/j	날/ncn	은/j
섬유의날의	섬유/ncn	의/j	날/ncn	의/j
섬유의날은	섬유/ncn	의/j	날/ncn	은/j
섬유의날에	섬유/ncn	의/j	날/ncn	에/j
섬유의날을	섬유/ncn	의/j	날/ncn	을/j
섬유의날	섬유/ncn	의/j	날/ncn
풍선내의	풍선/ncn	내/xsn	의/j
리드인	리드/ncp	인/ncn
살수 여상법	살수/ncn	여상법/ncn
고 스톱은	고스톱/ncn	은/j
해뜨는시간	해/ncn	뜨/pv	는/ef	시간/ncn
해뜨는	해/ncn	뜨/pv	는/ef
해서	하/pv	어서/ef
돌 비디오	돌비디오/ncn
해입니까	해/ncn	이/jp	ㅂ니까/ef
해입니까?	해/ncn	이/jp	ㅂ니까/ef	?/sf
위상 편이	위상편이/ncn
젖 말리기	젖말리기/ncp
핵의문턱	핵/ncn	의/j	문턱/ncn
반지의제왕	반지/ncn	의/j	제왕/ncn
조경자격증	조경/ncp	자격증/ncn
니드 포	니드포/ncn
염해서	염하/pa	어서/ef
더 캣	더캣/ncn
미친가족	미치/pv	ㄴ/ef	가족/ncn
라면땡기는날	라면/ncn	땡기/pv	는/ef	날/ncn
어떡해의	어떡해/ncn	의/j
첫 경험	첫경험/ncp
사랑과우정사이	사랑/ncp	과/j	우정/ncn	사이/ncn
우정사이의	우정/ncn	사이/ncn	의/j
우정사이	우정/ncn	사이/ncn
맥스웰 만	맥스웰만/nq_loc
윈도우미디어	윈도우/ncn	미디어/ncn
윈도미디어	윈도/ncn	미디어/ncn
무기가없을까요	무기/ncn	가/j	없/pa	을까요/ef
무기가없을까요?	무기/ncn	가/j	없/pa	을까요/ef	?/sf
팔길이와	팔/ncn	길이/ncn	와/j
팔길이	팔/ncn	길이/ncn
성기운동법좀	성기/ncn	운동법/ncn	좀/j
엠씨봤던	엠씨/ncn	보/pv	았/ep	던/ef
과속 감지	과속/ncp	감지/ncp
과속감지	과속/ncp	감지/ncp
가을가지는	가을/ncn	가지/ncn	는/j
죽을 쑨	죽/ncn	을/j	쑤/pv	ㄴ/ef
죽을쑨	죽/ncn	을/j	쑤/pv	ㄴ/ef
죽쑨	죽/ncn	쑤/pv	ㄴ/ef
발명의날	발명/ncp	의/j	날/ncn
이지스 함	이지스함/ncn
이지스 함은	이지스함/ncn	은/j
이지스 함이	이지스함/ncn	이/j
이지스 함의	이지스함/ncn	의/j
이지스 함을	이지스함/ncn	을/j
최고속도	최고/ncn	속도/ncn
연구형핵커	연구/ncp	형/xsn	핵커/ncn
창조적파괴	창조/ncp	적/xsn	파괴/ncp
연구형해커	연구/ncp	형/xsn	해커/ncn
기준시가	기준/ncn	시가/ncn
기준 시가	기준/ncn	시가/ncn
쓴 소리	쓴소리/ncp
쓴 소리를	쓴소리/ncp	를/j
창가의토토	창가/ncn	의/j	토토/ncn
신문의날	신문/ncn	의/j	날/ncn
바로 가는	바로가/pv	는/ef
노 브레인	노브레인/ncn
머리가 돈	머리/ncn	가/j	돌/pv	ㄴ/ef
바코드의역사	바코드/ncn	의/j	역사/ncn
응급실행	응급실/ncn	행/xsn
침묵의봄	침묵/ncp	의/j	봄/ncn
위대한유산	위대/ncp	하/xsp	ㄴ/ef	유산/ncn
과	과/j
크 세주	크세주/ncn
미니 M	미니M/ncn
'미니 M'은	'/sl	미니M/ncn	'/sr	은/j
'미니 M'이	'/sl	미니M/ncn	'/sr	이/j
프리다 칼로	프리다/nq_per	칼로/nq_per
첫눈온날좀	첫눈/ncn	오/pv	ㄴ/ef	날/ncn	좀/ma
인더존	인/ncn	더/ma	존/ncn
용이 감독	용이/nq_per	감독/j
아니지 레드	아니지/nq_etc	레드/ncn
아니지레드	아니지/nq_etc	레드/ncn
아니지 레드레이벌	아니지/nq_etc	레드/ncn	레이벌/ncn
아니지(Arnage)	아니지/nq_etc	(/sl	Arnage/eng	)/sr
'아니지'	'/sl	아니지/nq_etc	'/sr
하지와	하지/ncn	와/j
하지에	하지/ncn	에/j
하지가	하지/ncn	가/j
문볼	문/ncn	볼/ncn
않는날	않/pa	는/ef	날/ncn
그림을그린	그림/ncn	을/j	그리/pv	ㄴ/ef
상두야학교가자	상두/nq_per	야/j	학교/ncn	가자/ncn
완전한사랑	완전/ncp	하/xsp	ㄴ/ef	사랑/ncp
천상의문	천상/ncn	의/j	문/ncn
필요가있다면	필요/ncp	가/j	있/pa	다면/ef
되바라진의	되바라지/pa	ㄴ/ef	의/j
한가요	하/pa	ㄴ가요/ef
한가요?	하/pa	ㄴ가요/ef	?/sf
유인우주선에	유인/ncp	우주선/ncn	에/j
유인우주선	유인/ncp	우주선/ncn
유인우주선이	유인/ncp	우주선/ncn	이/j
유인우주선으로	유인/ncp	우주선/ncn	으로/j
유인우주선을	유인/ncp	우주선/ncn	을/j
유인우주선인	유인/ncp	우주선/ncn	이/jp	ㄴ/ef
유인우주선에는	유인/ncp	우주선/ncn	에는/j
어떤것	어떤/mm	것/nbn
1%의어떤것	1%/ncn	의/j	어떤/mm	것/nbn
졸고있는	졸/pv	고/ef	있/pa	는/ef
바이기도	바/nbn	이/jp	기도/ef
바이다.	바/nbn	이/jp	다/ef	./sf
꺼리는	꺼리/pv	는/ef
하나로	하나/nn	로/j
내가	내/np	가/j
대한	대하/pv	ㄴ/ef
기업인	기업/ncn	이/jp	ㄴ/ef
말로	말/ncn	로/j
개인가?	개/nbu	이/jp	ㄴ가/ef	?/sf
개인가요?	개/nbu	이/jp	ㄴ가요/ef	?/sf
개인가	개/nbu	이/jp	ㄴ가/ef	
개인가요	개/nbu	이/jp	ㄴ가요/ef
입니까?	이/jp	ㅂ니까/ef	?/sf
입니가?	이/jp	ㅂ니가/ef	?/sf
입니까	이/jp	ㅂ니까/ef
입니가	이/jp	ㅂ니가/ef
인가요?	이/jp	ㄴ가요/ef	?/sf
인가여?	이/jp	ㄴ가여/ef	?/sf
인가요	이/jp	ㄴ가요/ef
인가여	이/jp	ㄴ가여/ef
인지요?	이/jp	ㄴ지요/ef	?/sf
인지요	이/jp	ㄴ지요/ef
건가요?	거/nbn	ㄴ가요/jp	?/sf
건가여?	거/nbn	ㄴ가여/jp	?/sf
건가요	거/nbn	ㄴ가요/jp
건가여	거/nbn	ㄴ가여/jp
걸까요?	거/nbn	ㄹ까요/jp	?/sf
걸까여?	거/nbn	ㄹ까여/jp	?/sf
걸까요	거/nbn	ㄹ까요/jp
걸까여	거/nbn	ㄹ까여/jp
온건가요	오/pv	ㄴ건가요/ef
온건가요?	오/pv	ㄴ건가요/ef	?/sf
가려면	가/pv	려면/ef
갈려면	가/pv	ㄹ려면/ef
하나요	하/pv	나요/ef	
하나요?	하/pv	나요/ef	?/sf
색인가요	색/ncn	이/jp	ㄴ가요/ef
색인가요?	색/ncn	이/jp	ㄴ가요/ef	?/sf
어딘지	어디/np	ㄴ지/ef
사고	사/pv	고/ef
정돈지	정도/ncn	ㄴ지/ef
뭘로	무엇/np	으로/j
걸로	것/nbn	으로/j
물로	물/ncn	로/j
몬지	뭐/np	ㄴ지/ef
거지요	것/nbn	이/jp	지요/ef
거지요?	것/nbn	이/jp	지요/ef	?/sf
왜인지요	왜/ma	이/jp	ㄴ지요/ef
왜인지요?	왜/ma	이/jp	ㄴ지요/ef	?/sf
왜인가요	왜/ma	이/jp	ㄴ가요/ef
왜인가요?	왜/ma	이/jp	ㄴ가요/ef	?/sf
정상인가요	정상/ncn	이/jp	ㄴ가요/ef
정상인가요?	정상/ncn	이/jp	ㄴ가요/ef	?/sf
일이	일/ncn	이/j
이를	이/ncn	를/j
건지요	것/nbn	이/jp	ㄴ지요/ef
건지요?	것/nbn	이/jp	ㄴ지요/ef	?/sf
건지	것/nbn	이/jp	ㄴ지/ef
거지만	것/nbn	이/jp	지만/ef
배와	배/ncn	와/j
꾸면	꾸/pv	면/ef
아무도	아무/np	도/j
가려면	가/pv	려면/ef
가려는데	가/pv	려는데/ef
갈라면	가/pv	려면/ef
갈라면?	가/pv	려면/ef	?/sf
양털깎이	양털/ncn	깎이/ncn
오이깎이에	오이/ncn	깎이/ncn	에/j
오이깎이로	오이/ncn	깎이/ncn	로/j
오이깎이같은	오이/ncn	깎이/ncn	같은/j
오이깎이	오이/ncn	깎이/ncn
호두깎이	호두/ncn	깎이/ncn
발톱깎이	발톱/ncn	깎이/ncn
누리텔레콤은	누리/ncn	텔레콤/ncn	은/j
누리사업의	누리/ncn	사업/ncn	의/j
누리사업에	누리/ncn	사업/ncn	에/j
평화누리	평화/ncn	누리/ncn
누리사업	누리/ncn	사업/ncn
어울림누리	어울림/ncn	누리/ncn
덕양어울림누리	덕양/ncn	어울림/ncn	누리/ncn
누리사업단	누리/ncn	사업단/ncn
밑돌	밑돌/ncn
계단밑돌,	계단/ncn	밑돌/ncn	,/sp
리라컴퓨터고가	리라/ncn	컴퓨터/ncn	고가/ncn
리라초등학교에	리라/ncn	초등/ncn	학교/ncn	에/j
리라초등학교	리라/ncn	초등/ncn	학교/ncn
리라를	리라/ncn	를/j
뭉친	뭉치/pv	ㄴ/ef
뭉치고	뭉치/pv	고/ef
뭉치면살고	뭉치/pv	면/ef	살/pv	고/ef
뭉치자	뭉치/pv	자/ef
뭉치도록	뭉치/pv	도록/ef
뭉치는때도	뭉치/pv	는때/ef	도/j
뭉칠까요?	뭉치/pv	ㄹ까요/ef	?/sf
갈기머리	갈기/ncn	머리/ncn
사자갈기를	사자/ncn	갈기/ncn	를/j
사자갈기	사자/ncn	갈기/ncn
외화벌이가	외화/ncn	벌이/ncn	가/j
'돌리'가	'/sl	돌리/ncn	'/sr	가/j
돌리의	돌리/ncn	의/j
'돌리'에	'/sl	돌리/ncn	'/sr	에/j
`돌리'를	`/sl	돌리/ncn	'/sr	를/j
위엔님	위엔/nq_per	님/xsn_nq
위엔님은	위엔/nq_per	님/xsn_nq	은/j
피하지방이	피하/ncn	지방/ncn	이/j
피하투여	피하/ncn	투여/ncp
피하지방보다	피하/ncn	지방/ncn	보다/j
피하지방의	피하/ncn	지방/ncn	의/j
피하출혈과	피하/ncn	출혈/ncp	과/j
피하지방과	피하/ncn	지방/ncn	과/j
피하지방에서	피하/ncn	지방/ncn	에서/j
우리고	우리/pv	고/ef
신나를	신나/ncn	를/j
해치커버	해치/ncn	커버/ncp
해치레슨	해치/ncn	레슨/ncn
`해치상'을	`/sl	해치/ncn	상/ncn	'/sr	을/j
오리부리	오리/ncn	부리/ncn
앞부리가	앞/ncn	부리/ncn	가/j
앞부리보다	앞/ncn	부리/ncn	보다/j
노랑부리백로	노랑/ncn	부리/ncn	백로/ncn
독수리부리가	독수리/ncn	부리/ncn	가/j
독수리부리를	독수리/ncn	부리/ncn	를/j
바닐라퍼지	바닐라/ncn	퍼지/ncn
퍼지를	퍼지/ncn	를/j
피해지	피해지/ncn
대형산불피해지	대형/ncn	산불/ncn	피해지/ncn
산불피해지	산불/ncn	피해지/ncn
산림피해지	산림/ncn	피해지/ncn
피해지를	피해지/ncn	를/j
피해지에	피해지/ncn	에/j
피해지,	피해지/ncn	,/sp
피해지가	피해지/ncn	가/j
피해지인	피해지/ncn	이/jp	ㄴ/ef
산불피해지에서	산불/ncn	피해지/ncn	에서/j
인명피해지	인명/ncn	피해지/ncn
산불피해지가	산불/ncn	피해지/ncn	가/j
폭설피해지를	폭설/ncn	피해지/ncn	를/j
한국인다운	한국인/ncn	답/xsp	운/ef
신세대다운	신세대/ncn	답/xsp	운/ef
직업다운	직업/ncn	답/xsp	운/ef
연기자다운	연기자/ncn	답/xsp	운/ef
중앙지와	중앙지/ncn	와/j
중앙지	중앙지/ncn
중앙지에도	중앙지/ncn	에도/j
박차를	박차/ncn	를/j
상품전시회를	상품/ncn	전시회/ncn	를/j
한국상품전시회	한국/ncn	상품/ncn	전시회/ncn
친환경상품전시회	친환경/ncn	상품/ncn	전시회/ncn
풍기물란	풍기/ncn	물란/ncp
튀기한테	튀기/ncn	한테/j
안나오더군요	안/xs	나오/pv	더군요/ef
안나네요	안/xs	나/pv	네요/ef
안나고	안/xs	나/pv	고/ef
안나서	안/xs	나/pv	서/ef
안나와도	안/xs	나오/pv	아도/ef
안나더군요	안/xs	나/pv	더군요/ef
안나오니	안/xs	나오/pv	니/ef
안나오기	안/xs	나오/pv	기/etn
안나올경우	안/xs	나오/pv	ㄹ/ef	경우/ncn
안나는데	안/xs	나/pv	는데/ef
안나오던	안/xs	나오/pv	던/ef
안나면	안/xs	나/pv	면/ef
안나도록	안/xs	나/pv	도록/ef
안나질	안/xs	나/pv	질/ef
차회예고	차회/ncn	예고/ncp
차회	차회/ncn
음가가	음가/ncn	가/j
교수이면서	교수/ncn	이/jp	면서/ef
동기생이면서	동기생/ncn	이/jp	면서/ef
영화이면서	영화/ncn	이/jp	면서/ef
유독물이면서	유독물/ncn	이/jp	면서/ef
계정인지	계정/ncn	이/jp	ㄴ지/ef
과제인지	과제/ncn	이/jp	ㄴ지/ef
사무실인지,	사무실/ncn	이/jp	ㄴ지/ef	,/sp
사실인지	사실/ncn	이/jp	ㄴ지/ef
상황인지	상황/ncn	이/jp	ㄴ지/ef
선의인지,	선의/ncn	이/jp	ㄴ지/ef	,/sp
선택인지	선택/ncp	이/jp	ㄴ지/ef
순정품인지를	순정품/ncn	이/jp	ㄴ지를/ef
실수인지,	실수/ncp	이/jp	ㄴ지/ef	,/sp
악의인지	악의/ncn	이/jp	ㄴ지/ef
암살도구인지	암살/ncp	도구/ncn	이/jp	ㄴ지/ef
얼마인지	얼마/ncn	이/jp	ㄴ지/ef
운명인지	운명/ncp	이/jp	ㄴ지/ef
위기인지	위기/ncp	이/jp	ㄴ지/ef
의미인지	의미/ncn	이/jp	ㄴ지/ef
일인지	일/ncn	이/jp	ㄴ지/ef
일인지,	일/ncn	이/jp	ㄴ지/ef	,/sp
제품인지	제품/ncn	이/jp	ㄴ지/ef
조정차원인지	조정/ncp	차원/ncn	이/jp	ㄴ지/ef
종류인지	종류/ncn	이/jp	ㄴ지/ef
테러인지	테러/ncp	이/jp	ㄴ지/ef
해적판인지	해적판/ncn	이/jp	ㄴ지/ef
고체상태이면서	고체/ncn	상태/ncn	이/jp	면서/ef
관할이면서	관할/ncp	이/jp	면서/ef
노동당이면서	노동당/nq_etc	이/jp	면서/ef
동메달리스트이면서	동메달/ncn	리스트/ncn	이/jp	면서/ef
생물학자이면서	생물학자/ncn	이/jp	면서/ef
소속이면서도	소속/ncp	이/jp	면서도/ef
수급자이면서	수급자/ncn	이/jp	면서/ef
신분이면서도	신분/ncn	이/jp	면서도/ef
아들이면서	아들/ncn	이/jp	면서/ef
유지한다면서	유지/ncp	하/xsp	ㄴ다면서/ef
이동하면서	이동/ncp	하/xsp	면서/ef
입장이면서도	입장/ncn	이/jp	면서도/ef
작품이면서도	작품/ncn	이/jp	면서도/ef
장신이면서도	장신/ncn	이/jp	면서도/ef
판화이면서도	판화/ncn	이/jp	면서도/ef
전문가들보다	전문가/ncn	들/xsn	보다/j
우릴	우리/ncn	ㄹ/j
구음하며	구음/ncn	하/xsp	며/ef
무용학원인	무용/ncn	학원/ncn	이/jp	ㄴ/ef
전주시내	전주/nq_loc	시내/ncn
보세요	보/pv	세요/ef
하세요 	하/pv	세요/ef
봅시다	보/pv	ㅂ시다/ef
두세요	두/pv	세요/ef
미국서는	미국/nq_loc	서는/j
몰리고	몰리/pv	고/ef
몰리는	몰리/pv	는/ef
마치고	마치/pv	고/ef
누르고	누르/pv	고/ef
서슴치	서슴/pv	치/ef
해로운	해롭/pa	ㄴ/ef
심해지자	심하/pa	어지/ep	자/ef
국민들보다	국민/ncn	들/xsn	보다/j
가지고도	가지/pv	고/ep	도/ef
위해서가	위하/pv	어서/ep	가/ef
차지하니	차지/ncp	하/xsp	니/ef
조선사회의	조선/ncn	사회/ncn	의/j
어린	어리/pa	ㄴ/ef
하나라고	하나/nn	라/jp	고/ef
알기가	알/pv	기/etn	가/j
팔다가	팔/pv	다가/ef
시설대여업자가	시설/ncn	대여업/ncn	자/xsn	가/j
시설대여업자의	시설/ncn	대여업/ncn	자/xsn	의/j
시설등록사항의	시설/ncn	등록/ncp	사항/ncn	의/j
시설물을구간별	시설물/ncn	을/j	구간/ncn	별/xsn
시설보호지구로	시설/ncn	보호/ncp	지구/ncn	로/j
시설비용의	시설/ncn	비용/ncn	의/j
시설생활인	시설/ncn	생활인/ncn
시설설치자가	시설/ncn	설치자/ncn	가/j
시설설치자의	시설/ncp	설치자/ncn	의/j
시설자가	시설자/ncn	가/j
시설투자비용의	시설/ncn	투자/ncp	비용/ncn	의/j
시설화의	시설/ncn	화/xsn	의/j
시스템에로	시스템/ncn	에로/ncn
시유지상의	시유지/ncn	상/xsn	의/j
시작기기	시작/ncp	기기/ncn
시작시간에이루어	시작/ncp	시간/ncn	에/j	이루/pv	어/ef
시장경재	시장/ncp	경재/ncn
시장경제체제하의	시장/ncp	경제/ncn	체제/ncn	하/xsn	의/j
시장경제화가	시장/ncp	경제/ncn	화/xsn	가/j
시장실패가	시장/ncn	실패/ncp	가/j
시장원리로만	시장/ncp	원리/ncn	로만/j
시장친화적	시장/ncp	친화/ncp	적/xsn
시장화로	시장/ncp	화/xsn	로/j
시정부가	시정부/ncn	가/j
시정부와	시정부/ncn	와/j
시정조치권고가	시정/ncp	조치/ncp	권고/ncp	가/j
시정조치권고등	시정/ncp	조치/ncp	권고/ncp	등/nbn
시정지시등	시정/ncp	지시/ncp	등/nbn
시행계획상	시행/ncp	계획/ncp	상/xsn
시행과정상의	시행/ncp	과정/ncn	상/xsn	의/j
시행령제2	시행령/ncn	제2/ncn
시행자별지원사	시행자/ncn	별/xsn	지원사/ncn
시행착오자의	시행착오/ncp	자/xsn	의/j
시험관리상	시험/ncp	관리/ncp	상/xsn
시험구의	시험구/ncn	의/j
시험기관중	시험/ncp	기관/ncn	중/nbn
시험문제작성상	시험/ncp	문제/ncn	작성/ncp	상/xsn
시험장소등	시험/ncp	장소/ncn	등/nbn
식물학상의	식물학/ncn	상/xsn	의/j
식민시대로	식민/ncn	시대/ncn	로/j
식민잔재청상	식민/ncn	잔재/ncn	청상/ncn
식민지지배하의	식민지/ncn	지배/ncp	하/xsn	의/j
식민통치정책상	식민/ncn	통치/ncp	정책/ncn	상/xsn
식사대등	식사대/ncn	등/nbn
식사대의	식사대/ncn	의/j
식육포장처리업자가	식육/ncp	포장/ncp	처리업/ncn	자/xsn	가/j
식육포장처리업자의	식육/ncp	포장/ncp	처리업/ncn	자/xsn	의/j
식품사고발생시	식품/ncn	사고/ncp	발생/ncp	시/xsn
식품용의	식품/ncn	용/xsn	의/j
식품의약품안전청장과	식품/ncn	의약품/ncn	안전청/ncn	장/xsn	과/j
식품접객업자가	식품/ncn	접객업/ncn	자/xsn	가/j
식품접객영업자가	식품/ncn	접객/ncp	영업/ncp	자/xsn	가/j
식품접객영업자의	식품/ncn	접객/ncp	영업/ncp	자/xsn	의/j
식품첨가물공전상의	식품/ncn	첨가물/ncn	공전/ncp	상/xsn	의/j
신고가격의	신고/ncp	가격/ncn	의/j
신고가액대로	신고/ncp	가액/ncn	대로/j
신고내역대로	신고/ncp	내역/ncn	대로/j
신고내용대로	신고/ncp	내용/ncn	대로/j
신고수리권자가	신고/ncp	수리권/ncn	자/xsn	가/j
신고전경제학파와	신/ncn	고전/ncn	경제/ncn	학파/ncn	와/j
신고전학파와	신/ncn	고전/ncn	학파/ncn	와/j
신고접수순은	신고/ncp	접수/ncp	순/ncn	은/j
신공장부지에	신/ncn	공장/ncn	부지/ncn	에/j
신국가로	신/ncn	국가/ncn	로/j
신규채용자훈련과정이외	신규/ncn	채용자/ncn	훈련/ncp	과정/ncn	이외/ncn
신기기와	신/ncn	기기/ncn	와/j
신기술사업금융업자가	신기술/ncn	사업/ncp	금융업/ncn	자/xsn	가/j
신기술사업금융업자의	신기술/ncn	사업/ncp	금융업/ncn	자/xsn	의/j
신념체계상	신념/ncn	체계/ncn	상/xsn
신뢰자의	신뢰/ncp	자/xsn	의/j
신문발행업자의	신문/ncp	발행업/ncn	자/xsn	의/j
신문사항등	신문/ncp	사항/ncn	등/nbn
신발전국가로	신/ncn	발전/ncp	국가/ncn	로/j
신분상속제도가	신분/ncn	상속/ncp	제도/ncn	가/j
신분상실로	신분/ncn	상실/ncp	로/j
신분상실의	신분/ncn	상실/ncp	의/j
신분제도가	신분/ncn	제도/ncn	가/j
신분증표의	신분/ncn	증표/ncn	의/j
신빙도가	신빙도/ncn	가/j
신빙성에	신빙성/ncn	에/j
신빙성에의문	신빙성/ncn	에/j	의문/ncp
신상법상	신/ncn	상법/ncn	상/xsn
신생독립국가나	신생/ncp	독립/ncp	국가/ncn	나/j
신생아외의	신생아/ncn	외/xsn	의/j
신소재지에	신/ncn	소재지/ncn	에/j
신용대출계약상	신용/ncp	대출/ncp	계약/ncp	상/xsn
신용보증심사기준상	신용/ncp	보증/ncp	심사/ncp	기준/ncn	상/xsn
신용보증약정상의	신용/ncp	보증/ncp	약정/ncp	상/xsn	의/j
신용보증채무가	신용/ncp	보증/ncp	채무/ncn	가/j
신용소비자보호법제의	신용/ncp	소비자/ncn	보호/ncp	법제/ncp	의/j
신용장거래관계상의	신용장/ncn	거래/ncp	관계/ncp	상/xsn	의/j
신용장거래이외	신용장/ncn	거래/ncp	이외/ncn
신용카드라함	신용/ncp	카드/ncn	라/jp	하/pv	ㅁ/etn
신용카드업자의	신용/ncp	카드업/ncn	자/xsn	의/j
신용카드채무가	신용/ncp	카드/ncn	채무/ncn	가/j
신용카드회원약관상	신용/ncp	카드/ncn	회원/ncn	약관/ncn	상/xsn
신의성실의	신의/ncn	성실/ncp	의/j
신인사시	신/ncn	인사/ncp	시/xsn
신인사행정의	신/ncn	인사/ncp	행정/ncn	의/j
신임자가	신임자/ncn	가/j
신임지로	신임지/ncn	로/j
신입식중	신입식/ncn	중/xsn
신입자가	신입자/ncn	가/j
신입자의	신입자/ncn	의/j
신자유화의	신/ncn	자유/ncn	화/xsn	의/j
신작물의	신/ncn	작물/ncn	의/j
신주발행사항의	신주/ncn	발행/ncp	사항/ncn	의/j
신주발행시	신주/ncn	발행/ncp	시/xsn
신청권자가	신청권/ncn	자/xsn	가/j
신청권자의	신청권/ncn	자/xsn	의/j
신청명의인과	신청/ncp	명의인/ncn	과/j
신청서대로	신청서/ncn	대로/j
신청서편	신청서/ncn	편/xsn
신청자격의	신청/ncp	자격/ncn	의/j
신체건강상	신체/ncn	건강/ncp	상/xsn
신체검사서로	신체/ncn	검사서/ncn	로/j
신체기능장애가	신체/ncn	기능/ncp	장애/ncn	가/j
신체부위별	신체/ncn	부위/ncn	별/xsn
신체상해로	신체/ncn	상해/ncp	로/j
신체적기능장애로	신체/ncn	적/xsn	기능/ncn	장애/ncn	로/j
신체조건과	신체/ncn	조건/ncn	과/j
신축분양자가	신축/ncp	분양자/ncn	가/j
신탁과세이론상	신탁/ncp	과세/ncp	이론/ncn	상/xsn
신탁법리상	신탁/ncp	법리/ncn	상/xsn
신탁업자가	신탁업/ncn	자/xsn	가/j
신탁업자의	신탁업/ncn	자/xsn	의/j
신탁업자중	신탁업/ncn	자/xsn	중/nbn
신탁제도도	신탁/ncp	제도/ncn	도/j
신탁표시부와	신탁/ncp	표시부/ncn	와/j
신탁표시부의	신탁/ncp	표시부/ncn	의/j
신통지에	신/ncn	통지/ncp	에/j
신통합주의의	신/ncn	통합/ncp	주의/ncp	의/j
신편제하	신/ncn	편제/ncp	하/xsn
신품구입가격의	신품/ncn	구입/ncp	가격/ncn	의/j
신호소가	신호소/ncn	가/j
신호소간	신호소/ncn	간/xsn
신호위반이	신호/ncp	위반/ncp	이/j
신호장과	신호장/ncn	과/j
신호적편제의	신/ncn	호적/ncn	편제/ncp	의/j
신호종류별	신호/ncp	종류/ncn	별/xsn
실내온도설정부와	실내/ncn	온도/ncn	설정부/ncn	와/j
실명전환기	실명/ncp	전환기/ncn
실비변상조로	실비/ncn	변상/ncp	조/nbn	로/j
실비조로	실비/ncn	조/nbn	로/j
실수입자가	실수입/ncn	자/xsn	가/j
실수입자의	실수입/ncn	자/xsn	의/j
실습자가	실습자/ncn	가/j
실습자의	실습자/ncn	의/j
실시계획승인권자가	실시/ncp	계획/ncp	승인권/ncn	자/xsn	가/j
실시기간내의	실시/ncp	기간/ncn	내/xsn	의/j
실시자가	실시자/ncn	가/j
실시자의	실시자/ncn	의/j
실연자가	실연자/ncn	가/j
실연자의	실연자/ncn	의/j
실정도덕체계조차	실정/ncp	도덕/ncn	체계/ncn	조차/j
실정법학자의	실정법학/ncn	자/xsn	의/j
실지감사통할자가	실지/ncn	감사/ncp	통할자/ncn	가/j
실지감사통할자의	실지/ncn	감사/ncp	통할자/ncn	의/j
실천철학적	실천/ncp	철학/ncn	적/xsn
실행계획성격의	실행/ncp	계획/ncp	성격/ncn	의/j
실행도가	실행도/ncn	가/j
실험도구화의	실험/ncp	도구/ncn	화/xsn	의/j
실험성공과	실험/ncp	성공/ncp	과/j
실험자의	실험자/ncn	의/j
실현기가	실현기/ncn	가/j
실화자의	실화자/ncn	의/j
심각도가	심각도/ncn	가/j
심급관활	심급/ncn	관활/ncp
심리불속행의	심리/ncp	불속행/ncn	의/j
심사과정의	심사/ncp	과정/ncn	의/j
심사권한과	심사/ncp	권한/ncn	과/j
심사기준상	심사/ncp	기준/ncn	상/xsn
심사비용의	심사/ncp	비용/ncn	의/j
심사자가	심사자/ncn	가/j
심신미약자의	심신/ncp	미약/ncp	자/xsn	의/j
심신미약자인	심신/ncp	미약/ncp	자/xsn	이/jp	ㄴ/efa
심의절차상	심의/ncp	절차/ncn	상/xsn
심층도가	심층도/ncn	가/j
심층성에	심층성/ncn	에/j
심층연구과제로	심층/ncn	연구/ncp	과제/ncn	로/j
심판대상규범의	심판/ncp	대상/ncn	규범/ncn	의/j
심판변론인과	심판/ncp	변론인/ncn	과/j
심판정속수	심판/ncp	정속수/ncn
십자가상의	십자가/ncn	상/xsn	의/j
쌍태아가	쌍태아/ncn	가/j
아동복지지	아동복/ncn	지지/ncp
아파트거래기준표상의	아파트/ncn	거래/ncp	기준표/ncn	상/xsn	의/j
아파트건축업자인	아파트/ncn	건축업/ncn	자/xsn	이/jp	ㄴ/efa
아파트관리업무가	아파트/ncn	관리/ncp	업무/ncn	가/j
아파트관리업체도	아파트/ncn	관리/ncp	업체/ncn	도/j
아파트분양자가	아파트/ncn	분양자/ncn	가/j
아파트상가분양계약상	아파트/ncn	상가/ncn	분양/ncp	계약/ncp	상/xsn
안보지향적	안보/ncp	지향/ncp	적/xsn
안전관리부총괄자의	안전/ncp	관리부/ncn	총괄/ncp	자/xsn	의/j
안전관리상	안전/ncp	관리/ncp	상/xsn
안전점검자의	안전/ncp	점검자/ncn	의/j
안정성장과	안정/ncp	성장/ncp	과/j
알선수재자가	알선/ncp	수재/ncp	자/xsn	가/j
압류물의	압류물/ncn	의/j
압류일과	압류일/ncn	과/j
압축기와	압축기/ncn	와/j
액상화물질의	액상/ncn	화/xsn	물질/ncn	의/j
액화석유가스시	액화/ncp	석유/ncn	가스/ncn	시/xsn
야간제의	야간제/ncn	의/j
약국경영과	약국/ncn	경영/ncp	과/j
약국등록사항의	약국/ncn	등록/ncp	사항/ncn	의/j
약물남용자가	약물/ncn	남용/ncp	자/xsn	가/j
약물사용권리나	약물/ncn	사용/ncp	권리/ncn	나/j
약속어음금은	약속/ncp	어음금/ncn	은/j
약속오음	약속/ncp	오음/ncn
약주판매장소가	약주/ncn	판매/ncp	장소/ncn	가/j
양곡가공업자가	양곡/ncn	가공업/ncn	자/xsn	가/j
양곡매매업자의	양곡/ncn	매매업/ncn	자/xsn	의/j
양곡증권계정의	양곡/ncn	증권/ncn	계정/ncn	의/j
양극단치의	양극단/ncn	치/xsn	의/j
양당제도가	양당/ncn	제도/ncn	가/j
양도담보권설정자가	양도/ncp	담보권/ncn	설정/ncp	자/xsn	가/j
양도담보권설정자의	양도/ncp	담보권/ncn	설정/ncp	자/xsn	의/j
양도담보설정자가	양도/ncp	담보/ncp	설정/ncp	자/xsn	가/j
양도담보설정자의	양도/ncp	담보/ncp	설정/ncp	자/xsn	의/j
양도담보제도가	양도/ncp	담보/ncp	제도/ncn	가/j
양도담보제도로	양도/ncp	담보/ncp	제도/ncn	로/j
양도담보조로	양도/ncp	담보/ncp	조/nbn	로/j
양도소극세의	양도/ncp	소극세/ncn	의/j
양돈업자가	양돈업/ncn	자/xsn	가/j
양반가정의	양반/ncn	가정/ncp	의/j
양부모란	양부모/ncn	란/j
양성차별적	양성/ncp	차별/ncp	적/xsn
양식물의	양식물/ncn	의/j
양식산업과	양식/ncp	산업/ncn	과/j
양식어장시	양식어/ncn	장시/ncn
양식어장시설기	양식/ncp	어장/ncn	시설기/ncn
양안교류법제의	양안/ncn	교류/ncp	법제/ncp	의/j
양육권자의	양육권/ncn	자/xsn	의/j
양육자지정의	양육자/ncn	지정/ncp	의/j
양친자의	양친자/ncn	의/j
양형통제기능이	양형/ncn	통제/ncp	기능/ncp	이/j
어선법상의	어선법/ncn	상/xsn	의/j
어업권자가	어업권/ncn	자/xsn	가/j
어업권자의	어업권/ncn	자/xsn	의/j
어업권자인	어업권/ncn	자/xsn	이/jp	ㄴ/efa
어업등행정처분과	어업/ncn	등/nbn	행정/ncn	처분/ncp	과/j
어업용수의	어업/ncn	용수/ncn	의/j
어음액면금인	어음/ncn	액면금/ncn	이/jp	ㄴ/efa
어학특채자의	어학/ncn	특채자/ncn	의/j
어항지정의	어항/ncn	지정/ncp	의/j
어항청소선의	어항/ncn	청소선/ncn	의/j
어획물운반업자가	어획물/ncn	운반업/ncn	자/xsn	가/j
어획물운반업자의	어획물/ncn	운반업/ncn	자/xsn	의/j
억류지에	억류지/ncn	에/j
업무과로로	업무/ncn	과로/ncp	로/j
업무권한의	업무/ncn	권한/ncn	의/j
업무상과실치사상등	업무/ncn	상/xsn	과실/ncn	치사상/ncn	등/nbn
업무용토지에	업무/ncn	용/xsn	토지/ncn	에/j
업무이해도가	업무/ncn	이해도/ncn	가/j
업무집행권한상실선고의	업무/ncn	집행/ncp	권한/ncn	상실/ncp	선고/ncp	의/j
업무집행지시자의	업무/ncn	집행/ncp	지시자/ncn	의/j
에너지세제의	에너지/ncn	세제/ncn	의/j
에너지전담부서설	에너지/ncn	전담/ncp	부서/ncn	설/ncp
엔터테인먼트사가	엔터테인먼트/ncn	사/xsn	가/j
여관업주가	여관/ncn	업주/ncn	가/j
여관업주의	여관/ncn	업주/ncn	의/j
여성정책전담부서가	여성/ncn	정책/ncn	전담/ncp	부서/ncn	가/j
여행기간도	여행/ncp	기간/ncn	도/j
여행사실의	여행/ncp	사실/ncn	의/j
여행업자가	여행업/ncn	자/xsn	가/j
여행업자의	여행업/ncn	자/xsn	의/j
여행주선자가	여행/ncp	주선자/ncn	가/j
여행주선자의	여행/ncp	주선자/ncn	의/j
역노동조합의	역/ncn	노동/ncp	조합/ncp	의/j
역사법학파와	역사/ncp	법학파/ncn	와/j
역사학회로	역사/ncp	학회/ncn	로/j
역청유의	역청유/ncn	의/j
역할관게	역할/ncp	관게/ncp
연결관계가	연결/ncp	관계/ncp	가/j
연결부위의	연결/ncp	부위/ncn	의/j
연결부재의	연결/ncp	부재/ncp	의/j
연결재무재표	연결/ncp	재무재표/ncn
연계관게	연계/ncp	관게/ncp
연고권자가	연고권/ncn	자/xsn	가/j
연고권자의	연고권/ncn	자/xsn	의/j
연공서열제로	연공/ncn	서열제/ncn	로/j
연구개발사업계획과	연구/ncp	개발/ncp	사업/ncp	계획/ncp	과/j
연구과정의	연구/ncp	과정/ncn	의/j
연구과제도	연구/ncp	과제/ncn	도/j
연구단계가	연구/ncp	단계/ncn	가/j
연구단위로	연구/ncp	단위/ncn	로/j
연구단지가	연구/ncp	단지/ncn	가/j
연구부문의	연구/ncp	부문/ncn	의/j
연구부서로	연구/ncp	부서/ncn	로/j
연구사조로	연구/ncp	사조/ncn	로/j
연구사조의	연구/ncp	사조/ncn	의/j
연구생활화의	연구/ncp	생활/ncp	화/xsn	의/j
연구전담부서가	연구/ncp	전담/ncp	부서/ncn	가/j
연구학원도	연구/ncp	학원/ncn	도/j
연금기록상황의	연금/ncp	기록/ncp	상황/ncn	의/j
연단위로	연/ncn	단위/ncn	로/j
연대보증게약	연대/ncp	보증/ncp	게약/ncp
연령자의	연령자/ncn	의/j
연말정산사업소득의	연말/ncn	정산/ncp	사업/ncp	소득/ncn	의/j
연명부와	연명부/ncn	와/j
연방국가나	연방/ncn	국가/ncn	나/j
연방국가라	연방/ncn	국가/ncn	라/jp
연방국가이	연방/ncn	국가/ncn	이/jp
연방국가인	연방/ncn	국가/ncn	이/jp	ㄴ/efa
연방금융감독권자의	연방/ncn	금융/ncn	감독권/ncn	자/xsn	의/j
연방제안과의	연방제/ncn	안/xsn	과의/j
연방제제의	연방제/ncn	제의/ncp
연속감사가	연속/ncp	감사/ncp	가/j
연속기초로	연속/ncp	기초/ncp	로/j
연쇄방화사건의	연쇄/ncp	방화/ncp	사건/ncn	의/j
연수기구의	연수/ncp	기구/ncn	의/j
연수기회의	연수/ncp	기회/ncn	의/j
연수실적의	연수/ncp	실적/ncn	의/j
연약지에	연약지/ncn	에/j
연예상과	연예상/ncn	과/j
연와조로	연와조/ncn	로/j
연장선상이	연장/ncp	선상/ncn	이/j
연체손해금도	연체/ncp	손해금/ncn	도/j
연초경작구역지정의	연초/ncn	경작/ncp	구역/ncn	지정/ncp	의/j
연탄가스중독사고가	연탄/ncp	가스/ncn	중독/ncp	사고/ncn	가/j
연합뉴스사가	연합뉴스/ncn	사/xsn	가/j
연합서비스표의	연합/ncp	서비스/ncn	표/ncn	의/j
열관리사가	열/ncn	관리사/ncn	가/j
열제거가	열/ncn	제거/ncp	가/j
열제거기능이	열/ncn	제거/ncp	기능/ncp	이/j
염색조로	염색조/ncn	로/j
염전경영과	염전/ncp	경영/ncp	과/j
염좌상과	염좌상/ncn	과/j
염좌상이	염좌상/ncn	이/j
영국도선법상	영국/nq_loc	도선법/ncn	상/xsn
영국법과	영국/nq_loc	법/ncn	과/j
영국식인	영국/nq_loc	식/xsn	이/jp	ㄴ/efa
영농보혈초가	영농/ncp	보혈초/ncn	가/j
영문법전이	영문/ncn	법전/ncn	이/j
영미법계가	영미/nq_loc	법계/ncn	가/j
영미법계적	영미/nq_loc	법계/ncn	적/xsn
영상녹화물의	영상/ncn	녹화물/ncn	의/j
119안전신고센터시스템	119/ncn	안전/ncp	신고/ncp	센터/ncn	시스템/ncn
가공전의	가공/ncp	전/ncn	의/j
가권자가	가권자/ncn	가/j
가납금은	가납금/ncn	은/j
가도교의	가도교/ncn	의/j
가량물의	가량물/ncn	의/j
가로수외의	가로수/ncn	외/xsn	의/j
가맹거래사가	가맹/ncp	거래사/ncn	가/j
가맹거래사임	가맹/ncp	거래사/ncn	이/jp	ㅁ/etn
가불하계	가불/ncp	하계/ncn
가사관련비등	가사/ncn	관련비/ncn	등/nbn
가상세계인	가상/ncp	세계/ncn	이/jp	ㄴ/efa
가스검정기로	가스/ncn	검정기/ncn	로/j
가스검정기의	가스/ncn	검정기/ncn	의/j
가스공급시설설치자의	가스/ncn	공급/ncp	시설/ncp	설치자/ncn	의/j
가스소매업자가	가스/ncn	소매업/ncn	자/xsn	가/j
가스외의	가스/ncn	외/xsn	의/j
가압류이의신청사건의	가압류/ncp	이의/ncp	신청/ncp	사건/ncn	의/j
가점평정하지	가점/ncp	평정/ncp	하/xsp	지/ef
가족과계	가족/ncn	과계/ncn
가족과계등록법	가족/ncn	과계/ncn	등록법/ncn
가족관계등록보고서편	가족/ncn	관계/ncp	등록/ncp	보고서/ncn	편/xsn
가족관계등록사	가족/ncn	관계/ncp	등록사/ncn
가족관계등록전산	가족/ncn	관계/ncp	등록/ncp	전산/ncn
가족어선원만	가족/ncn	어선원/ncn	만/j
가처분신청사	가처분/ncp	신청사/ncn
가축방역사로	가축/ncp	방역사/ncn	로/j
가축분뇨관련영업자의	가축/ncp	분뇨/ncn	관련/ncp	영업자/ncn	의/j
가축분뇨처리업자가	가축/ncp	분뇨/ncn	처리업/ncn	자/xsn	가/j
가축외동물의	가축/ncp	외/xsn	동물/ncn	의/j
가축위생연구소란	가축/ncp	위생/ncn	연구소/ncn	란/j
가퇴원자가	가퇴원/ncp	자/xsn	가/j
가퇴원자의	가퇴원/ncp	자/xsn	의/j
가퇴원취소자의	가퇴원/ncp	취소/ncp	자/xsn	의/j
각종표준기의	각종/ncn	표준기/ncn	의/j
간부직원인	간부/ncn	직원/ncn	이/jp	ㄴ/efa
간부회의의	간부/ncn	회의/ncp	의/j
간접비용의	간접/ncn	비용/ncn	의/j
간접투자재산중	간접/ncn	투자/ncp	재산/ncn	중/nbn
간질환자의	간/ncn	질환자/ncn	의/j
간첩이자	간첩/ncp	이/jp	자/ef
간호사관학교의	간호/ncp	사관/ncn	학교/ncn	의/j
간호원114	간호원/ncn	114/ncn
감가상각비용의	감가/ncp	상각/ncn	비용/ncn	의/j
감가상각특례자산외의	감가/ncp	상각/ncp	특례/ncn	자산/ncn	외/xsn	의/j
감독관계가	감독/ncp	관계/ncp	가/j
감독규정상	감독/ncp	규정/ncp	상/xsn
감사권한중	감사/ncp	권한/ncn	중/nbn
감사실적의	감사/ncp	실적/ncn	의/j
감사자의	감사자/ncn	의/j
감사처분심의회의의	감사/ncp	처분/ncp	심의/ncp	회의/ncp	의/j
감속도가	감속도/ncn	가/j
감속도로	감속/ncp	도로/ncn
감전사고가	감전/ncp	사고/ncn	가/j
감정가격등	감정/ncp	가격/ncn	등/nbn
감정유치자의	감정/ncp	유치자/ncn	의/j
감청자가	감청자/ncn	가/j
감호불청구의	감호/ncp	불청구/ncp	의/j
갑판상부적재외의	갑판/ncn	상부/ncp	적재/ncp	외/xsn	의/j
강간범의	강간범/ncn	의/j
강사이외	강사/ncn	이외/ncn
강행규정이자	강행/ncp	규정/ncp	이/jp	자/ef
개간자가	개간자/ncn	가/j
개발사업지에	개발/ncp	사업지/ncn	에/j
개발예정지구의	개발/ncp	예정/ncp	지구/ncn	의/j
개복수술의	개복/ncp	수술/ncp	의/j
개인기록표상의	개인/ncp	기록표/ncn	상/xsn	의/j
개인하수처리시설관리업자의	개인/ncp	하수/ncp	처리/ncp	시설/ncp	관리업/ncn	자/xsn	의/j
개정권자의	개정권/ncn	자/xsn	의/j
갱내굴착의	갱/ncn	내/xsn	굴착/ncp	의/j
갱신지정의	갱신/ncp	지정/ncp	의/j
갹출자가	갹출자/ncn	가/j
거래사례토지가	거래/ncp	사례/ncp	토지가/ncn
거래성립최저가격의	거래/ncp	성립/ncp	최저/ncn	가격/ncn	의/j
거래정지등	거래/ncp	정지/ncp	등/nbn
건물철거작업지시상	건물/ncn	철거/ncp	작업/ncp	지시/ncp	상/xsn
건설공정상	건설/ncp	공정/ncp	상/xsn
건설기계관리법상의	건설/ncp	기계/ncn	관리법/ncn	상/xsn	의/j
건설기계매매업자가	건설/ncp	기계/ncn	매매업/ncn	자/xsn	가/j
건설기계산업기사이상	건설/ncp	기계/ncn	산업/ncn	기사/ncp	이상/ncp
건설기계정비업자가	건설/ncp	기계/ncn	정비업/ncn	자/xsn	가/j
건설기술자의	건설/ncn	기술자/ncn	의/j
건설업등록사항의	건설업/ncn	등록/ncp	사항/ncn	의/j
건설재해중	건설/ncp	재해/ncn	중/nbn
건설폐기물중간처리업자가	건설/ncp	폐기물/ncn	중간/ncp	처리업/ncn	자/xsn	가/j
건설폐기물중간처리업자의	건설/ncp	폐기물/ncn	중간/ncp	처리업/ncn	자/xsn	의/j
건설폐기물처리업자가	건설/ncp	폐기물/ncn	처리업/ncn	자/xsn	가/j
건설폐기물처리업자의	건설/ncp	폐기물/ncn	처리업/ncn	자/xsn	의/j
건설현장외의	건설/ncp	현장/ncn	외/xsn	의/j
건설화사	건설/ncp	화사/ncp
건조장치의	건조/ncp	장치/ncp	의/j
건축물의대지가	건축물/ncn	의/j	대지/ncn	가/j
건축사업무신고부와	건축사/ncn	업무/ncn	신고부/ncn	와/j
건축사업무신고부의	건축사/ncn	업무/ncn	신고부/ncn	의/j
건축업자의	건축업/ncn	자/xsn	의/j
건축자가	건축자/ncn	가/j
건축자의	건축자/ncn	의/j
건축한계외의	건축/ncp	한계/ncn	외/xsn	의/j
건축허가부관상의	건축/ncp	허가/ncp	부관/ncp	상/xsn	의/j
검사계측기기의	검사/ncp	계측/ncp	기기/ncn	의/j
검사공소가	검사/ncp	공소/ncp	가/j
검사기관지정등	검사/ncp	기관/ncn	지정/ncp	등/nbn
검사대상기기가	검사/ncp	대상/ncp	기기/ncn	가/j
검사대상의	검사/ncp	대상/ncp	의/j
검사대행실적의	검사/대행/ncp	실적/ncn	의/j
검사장소가	검사/ncp	장소/ncn	가/j
검사장소등	검사/ncp	장소/ncn	등/nbn
검사장소로	검사/ncp	장소/ncn	로/j
검안비등	검안비/ncn	등/nbn
검인부의	검인부/ncn	의/j
검증목적물의	검증/ncp	목적물/ncn	의/j
검창사무관	검창/ncn	사무관/ncn
검창주사보	검창/ncn	주사보/ncn
게임물의	게임물/ncn	의/j
격리방법외의	격리/ncp	방법/ncn	외/xsn	의/j
결산순손실금은	결산/ncp	순/ncn	손실금/ncn	은/j
결재권자가	결재권자/ncn	가/j
결재권자의	결재권자/ncn	의/j
결정선고전의	결정/ncp	선고/ncp	전/xsn	의/j
결함확인검사대상의	결함/ncn	확인/ncp	검사/ncp	대상/ncp	의/j
결합서비스표의	결합/ncp	서비스/ncn	표/ncn	의/j
결혼기념촬영등	결혼/ncp	기념/ncp	촬영/ncp	등/nbu
결혼중개업자가	결혼/ncp	중개업/ncn	자/xsn	가/j
겸직자의	겸직자/ncn	의/j
경고문구등	경고/ncp	문구/ncn	등/nbn
경관보전직접지불제도로	경관/ncn	보전/ncp	직접/ncn	지불/ncp	제도/ncn	로/j
경매신청건물의	경매/ncp	신청/ncp	건물/ncn	의/j
경매신청권자가	경매/ncp	신청권/ncn	자/xsn	가/j
경매신청권자의	경매/ncp	신청권/ncn	자/xsn	의/j
경매진행절차상	경매/ncp	진행/ncp	절차/ncn	상/xsn
경비관련업외의	경비/ncp	관련업/ncn	외/xsn	의/j
경비업자가	경비업/ncn	자/xsn	가/j
경비업자의	경비업/ncn	자/xsn	의/j
경업자의	경업자/ncn	의/j
경업자인	경업자/ncn	이/jp	ㄴ/efa
경영계획구의	경영/ncp	계획구/ncn	의/j
경영관리사항의	경영/ncp	관리/ncp	사항/ncn	의/j
경영대행의	경영/ncp	대행/ncp	의/j
경영지도권한의	경영/ncp	지도/ncp	권한/ncn	의/j
경영지도사항의	경영/ncp	지도/ncp	사항/ncn	의/j
경영학자의	경영학자/ncn	의/j
경영학자인	경영학자/ncn	이/jp	ㄴ/efa
경작자재의	경작/ncp	자재/ncp	의/j
경쟁입찰참가자격외의	경쟁/ncp	입찰/ncp	참가/ncp	자격/ncn	외/xsn	의/j
경쟁입찰참가자격의	경쟁/ncp	입찰/ncp	참가/ncp	자격/ncn	의/j
경제가치의	경제/ncn	가치/ncn	의/j
경제권역인	경제/ncn	권역/ncn	이/jp	ㄴ/efa
경제사정등	경제/ncn	사정/ncp	등/nbn
경제사회구조로	경제/ncn	사회/ncn	구조/ncp	로/j
경제사회안정기반의	경제/ncn	사회/ncn	안정/ncp	기반/ncn	의/j
경주용구의	경주/ncn	용구/ncn	의/j
경찰관서가	경찰관서/ncn	가/j
계단부가	계단부/ncn	가/j
계약변경전의	계약/ncp	변경/ncp	전/xsn	의/j
계약사실과	계약/ncp	사실/ncn	과/j
계약상황의	계약/ncp	상황/ncn	의/j
계약해제자가	계약/ncp	해제자/ncn	가/j
계엄선포전의	계엄/ncp	선포/ncp	전/xsn	의/j
계열회사로만	계열/ncn	회사/ncp	로만/j
계측기기의	계측/ncp	기기/ncn	의/j
계호상의	계호/ncn	상/xsn	의/j
계획구로	계획구/ncn	로/j
계획도가	계획도/ncn	가/j
계획서대로	계획서/ncn	대로/j
고가부의	고가부/ncn	의/j
고개만족	고개/ncn	만족/ncp
고도산업복지사회의	고도/ncp	산업/ncn	복지/ncp	사회/ncn	의/j
고등기술하교	고등/ncp	기술/ncn	하교/ncp
고등기술하교졸업자	고등/ncp	기술/ncn	하교/ncp	졸업자/ncn
고속회전체외의	고속/ncn	회전체/ncn	외/xsn	의/j
고시지역내의	고시/ncp	지역/ncn	내/xsn	의/j
고용제한의	고용/ncp	제한/ncp	의/j
고용조정계획상	고용/ncp	조정/ncp	계획/ncp	상/xsn
고유권한인	고유/ncp	권한/ncn	이/jp	ㄴ/efa
고인물의	고이/pv	ㄴ/efa	물/ncn	의/j
고장자산	고장/ncp	자산/ncn
고장표시등	고장/ncp	표시등/ncn
고저차가	고저차/ncn	가/j
고정물의	고정물/ncn	의/j
고정부와	고정부/ncn	와/j
고체화학물질의	고체/ncn	화학/ncn	물질/ncp	의/j
고층처리	고층/ncn	처리/ncp
고형물의	고형물/ncn	의/j
골프회원권자의	골프/ncn	회원권/ncn	자/xsn	의/j
공개보류자의	공개/ncp	보류자/ncn	의/j
공공보건의료기관중	공공/ncn	보건/ncn	의료/ncn	기관/ncn	중/nbn
공급구의	공급구/ncn	의/j
공동광업권자가	공동/ncp	광업권/ncn	자/xsn	가/j
공동광업권자의	공동/ncp	광업권/ncn	자/xsn	의/j
공동광업권자중	공동/ncp	광업권/ncn	자/xsn	중/nbn
공동구로	공동구/ncn	로/j
공동근저당권자가	공동/ncp	근저당권/ncn	자/xsn	가/j
공동사업관계가	공동/ncp	사업/ncp	관계/ncp	가/j
공동실연자의	공동/ncp	실연자/ncn	의/j
공동자의	공동자/ncn	의/j
공동점유권자의	공동/ncp	점유권/ncn	자/xsn	의/j
공동조광권자의	공동/ncp	조광권/ncn	자/xsn	의/j
공동지분권자의	공동/ncp	지분권/ncn	자/xsn	의/j
공동출원자가	공동/ncp	출원/ncp	자/xsn	가/j
공동활용자의	공동/ncp	활용/ncp	자/xsn	의/j
공로금은	공로금/ncn	은/j
공무보전부의	공무/ncn	보전부/ncn	의/j
공무원정원표의	공무원/ncn	정원/ncn	표/ncn	의/j
공범자끼리	공범자/ncn	끼리/xsn
공법자의	공법자/ncn	의/j
공법자중	공법자/ncn	중/nbn
공보실장과	공보실/ncn	장/xsn	과/j
공보실장인	공보실/ncn	장/xsn	이/jp	ㄴ/efa
공사시공권자의	공사/ncp	시공권/ncn	자/xsn	의/j
공사업자가	공사업/ncn	자/xsn	가/j
공사업자의	공사업/ncn	자/xsn	의/j
공사잔대금조	공사/ncp	잔대금/ncn	조/xsn
공사전과	공사/ncp	전/xsn	과/j
공상자의	공상자/ncn	의/j
공소보류자의	공소/ncp	보류자/ncn	의/j
공소제기함의	공소/ncp	제기/ncp	하/xsp	ㅁ/etn	의/j
공안상의	공안/ncn	상/xsn	의/j
공업용도로	공업/ncn	용도/ncn	로/j
공원조성지구의	공원/ncn	조성/ncp	지구/ncn	의/j
공유지분권자가	공유/ncp	지분권/ncn	자/xsn	가/j
공유지분권자의	공유/ncp	지분권/ncn	자/xsn	의/j
공유지분권자인	공유/ncp	지분권/ncn	자/xsn	이/jp	ㄴ/efa
공유지분해당면적의	공유/ncp	지분/ncn	해당/ncp	면적/ncn	의/j
공익사업시행지구내의	공익/ncn	사업/ncp	시행/ncp	지구/ncn	내/xsn	의/j
공인노무사회로	공인/ncp	노무사회/ncn	로/j
공장근저당권자가	공장/ncn	근저당권/ncn	자/xsn	가/j
공장등록사항의	공장/ncn	등록/ncp	사항/ncn	의/j
공장입지기준면적의	공장/ncn	입지/ncp	기준/ncn	면적/ncn	의/j
공적자의	공적자/ncn	의/j
공전상의	공전/ncp	상/xsn	의/j
공제가입자증과	공제/ncp	가입자증/ncn	과/j
공제자의	공제자/ncn	의/j
공제회사가	공제/ncp	회사/ncn	가/j
공중목욕업자의	공중/ncn	목욕업/ncn	자/xsn	의/j
공중보건의사가	공중/ncn	보건/ncn	의사/ncn	가/j
공중보건의사로	공중/ncn	보건/ncn	의사/ncn	로/j
공중위생영업자가	공중/ncn	위생/ncn	영업자/ncn	가/j
공중위생영업자의	공중/ncn	위생/ncn	영업자/ncn	의/j
공중접객업자의	공중/ncn	접객업/ncn	자/xsn	의/j
공중충돌경고장치의	공중/ncn	충돌/ncp	경고/ncp	장치/ncp	의/j
공증서류검열자의	공증/ncp	서류/ncn	검열자/ncn	의/j
공증촉탁서가	공증/ncp	촉탁서/ncn	가/j
공탁사무취급점지정의	공탁/ncp	사무/ncp	취급점/ncn	지정/ncp	의/j
공판조서상의	공판/ncp	조서/ncn	상/xsn	의/j
공화당의	공화당/nq_etc	의/j
과단위의	과/ncn	단위/ncn	의/j
과반수지분권자가	과반수/ncn	지분권/ncn	자/xsn	가/j
과세권자의	과세권자/ncn	의/j
과세대상작물의	과세/ncp	대상/ncp	작물/ncn	의/j
과세제도도	과세/ncp	제도/ncn	도/j
과세처분권자가	과세/ncp	처분권/ncn	자/xsn	가/j
과세처분취소소송이	과세/ncp	처분/ncp	취소/ncp	소송/ncp	이/j
과정설치자가	과정/ncn	설치자/ncn	가/j
과정지정의	과정/ncn	지정/ncp	의/j
과태료부과자인	과태료/ncn	부과자/ncn	이/jp	ㄴ/efa
과학기술국가중	과학/ncn	기술/ncp	국가/ncn	중/nbn
관계소송제도도	관계/ncp	소송/ncp	제도/ncn	도/j
관계정립관계정립	관계/ncp	정립/ncp	관계/ncp	정립/ncp
관광단지가	관광/ncp	단지/ncp	가/j
관광숙박업자의	관광/ncp	숙박업/ncn	자/xsn	의/j
